p_______q
i...1...I
i.1...1.I
i.11X.1.I
i.11111.I
i.1.1...I
i.1.1.1.I
i.1...1.I
iS..111.I
l_______j
