p________q
i....11..I
i.S..1X..I
i.1..1...I
i.1..1...I
i.1..1...I
i.1..111.I
i........I
i........I
l________j
