p________q
i2...22..I
i22......I
i2.....2.I
i...2...2I
i.2.....2I
i...222..I
i.2....2.I
iX22....SI
l________j
