p________q
i....X3..I
i.333...3I
i3.33...3I
i.......3I
i..3....SI
i3.3.3..3I
i..3...3.I
i3...3...I
l________j
